BACK	B AE K
BEFORE	B IH F AO R
BEFORE(2)	B IY F AO R
DECREMENT	D EH K R AH M AH N T
DOWN	D AW N
HOME	HH OW M
INCREMENT	IH N K R AH M AH N T
LEFT	L EH F T
MAX	M AE K S
MAXIMUM	M AE K S AH M AH M
MUTE	M Y UW T
NEXT	N EH K S T
NEXT(2)	N EH K S
PAUSE	P AO Z
PLAY	P L EY
PREVIOUS	P R IY V IY AH S
RIGHT	R AY T
SELECT	S AH L EH K T
SHUTDOWN	SH AH T D AW N
STOP	S T AA P
ULTRON	AH L T R AH N
ULTRON (2)	AH L T R AH M
ULTRON (3)	AH T R AH M
ULTRON (4)	AH T R AH N
UP	AH P
VOLUME	V AA L Y UW M
